1111111111111111111111111
1E00000000110000000000001
1011110111110111110111101
1000000000000000000000001
1011101111011110111101111
1011101111011110111101111
1000000000000CC00000P0001
1111011110111110111101111
1111011110111110111101111
100000000011000000CC00001
1111111111111111111111111